0 0 0 0 0 0 0 0 0 0 0 0 0 0 0 0 0 0 0 0 0 0 0 0 0 0 0 0 0 0 0 0 0 0 0 0 0 0 0 0 0 0 0 0 0 0 0 0 0 0 0 0 0 0 0 0 0 0 0 0 0 0 0 0
0 0 0 0 52 1 2 2 2 2 2 2 2 2 3 4 52 1 2 2 2 2 2 2 2 2 3 4 52 1 2 2 2 2 2 2 2 2 3 4 0 0 0 0 0 0 0 0 0 0 0 0 0 0 0 0 0 0 0 0 0 0 0 0
0 0 0 0 5 6 7 7 8 9 7 7 7 7 10 11 5 6 7 7 7 7 8 9 7 7 10 11 5 6 7 7 8 9 7 7 7 7 10 11 0 0 0 0 0 0 0 0 0 0 0 0 0 0 0 0 0 0 0 0 0 0 0 0
0 0 0 0 12 14 15 13 13 13 13 13 13 13 16 17 12 13 13 14 15 13 13 13 13 13 16 17 12 14 15 13 13 13 13 13 13 13 16 17 0 0 0 0 0 0 0 0 0 0 0 0 0 0 0 0 0 0 0 0 0 0 0 0
0 0 0 0 12 18 13 13 13 13 13 13 13 13 16 17 12 18 13 13 13 20 20 13 13 13 16 17 12 18 13 13 13 13 13 13 13 13 16 17 0 0 0 0 0 0 0 0 0 0 0 0 0 0 0 0 0 0 0 0 0 0 0 0
0 0 0 0 12 18 21 19 13 13 21 21 13 19 16 17 12 18 20 20 13 13 13 13 13 13 16 17 12 18 19 19 13 13 13 19 19 20 16 17 0 0 0 0 0 0 0 0 0 0 0 0 0 0 0 0 0 0 0 0 0 0 0 0
0 0 0 0 12 18 13 13 13 13 13 22 13 13 16 17 12 18 19 13 13 13 19 20 19 13 16 17 12 13 13 13 13 13 13 13 13 13 16 17 0 0 0 0 0 0 0 0 0 0 0 0 0 0 0 0 0 0 0 0 0 0 0 0
0 0 0 0 12 18 13 13 13 13 13 13 13 13 16 17 12 18 13 13 13 13 13 13 13 13 21 17 12 18 19 20 13 13 21 13 13 13 16 17 0 0 0 0 0 0 0 0 0 0 0 0 0 0 0 0 0 0 0 0 0 0 0 0
0 0 0 0 12 18 19 19 13 13 19 20 21 19 16 17 12 18 13 13 13 13 13 13 13 13 16 17 12 18 13 13 13 13 13 13 19 20 19 17 0 0 0 0 0 0 0 0 0 0 0 0 0 0 0 0 0 0 0 0 0 0 0 0
0 0 0 0 12 19 19 13 13 13 21 19 13 13 16 17 12 18 13 13 13 13 13 13 13 13 16 17 12 19 19 13 19 20 13 13 13 13 16 17 0 0 0 0 0 0 0 0 0 0 0 0 0 0 0 0 0 0 0 0 0 0 0 0
0 0 0 0 23 24 25 25 25 25 25 25 25 25 26 27 23 24 25 25 25 25 25 25 25 25 26 27 23 24 25 25 25 25 25 25 25 25 26 27 0 0 0 0 0 0 0 0 0 0 0 0 0 0 0 0 0 0 0 0 0 0 0 0
52 1 2 2 27 28 29 30 30 30 30 30 30 30 30 31 32 28 29 30 30 30 30 30 30 30 30 31 32 28 29 30 30 30 30 30 30 30 30 31 32 2 2 3 0 0 0 0 0 0 0 0 0 0 0 0 0 0 0 0 0 0 0 0
4 5 6 6 1 39 39 39 39 39 40 39 39 39 39 39 39 39 39 39 39 39 40 39 39 39 39 39 39 39 39 39 39 39 40 39 39 39 39 39 3 2 2 3 4 0 0 0 0 0 0 0 0 0 0 0 0 0 0 0 0 0 0 0
12 13 13 13 41 41 41 41 42 41 41 41 41 41 41 41 41 41 41 41 42 41 41 41 41 41 41 41 41 41 41 41 42 41 41 41 41 41 13 13 16 17 0 0 0 0 0 0 0 0 0 0 0 0 0 0 0 0 0 0 0 0 0 0
12 13 13 13 43 43 43 43 43 43 43 43 43 43 43 43 43 43 43 43 43 43 43 43 43 43 43 43 43 43 43 43 43 43 43 43 43 43 13 13 16 17 0 0 0 0 0 0 0 0 0 0 0 0 0 0 0 0 0 0 0 0 0 0
12 13 13 13 43 43 43 43 43 43 43 43 43 43 43 43 43 43 43 43 43 43 43 43 43 43 43 43 43 43 43 43 43 43 43 43 43 43 13 13 16 17 0 0 0 0 0 0 0 0 0 0 0 0 0 0 0 0 0 0 0 0 0 0
23 24 25 25 44 44 44 44 44 44 44 44 44 44 44 44 44 44 44 44 44 44 44 44 44 44 44 44 44 44 44 44 44 44 44 44 44 44 25 25 26 27 0 0 0 0 0 0 0 0 0 0 0 0 0 0 0 0 0 0 0 0 0 0
27 28 29 29 52 1 2 2 2 2 2 2 2 2 3 4 52 1 2 2 2 2 2 2 2 2 3 4 52 1 2 2 2 2 2 2 2 2 3 4 30 30 31 32 0 0 0 0 0 0 0 0 0 0 0 0 0 0 0 0 0 0 0 0
0 0 0 0 5 6 7 7 8 9 7 7 51 7 10 11 5 6 7 51 7 7 8 9 7 7 10 11 5 6 7 7 8 9 7 7 51 7 10 11 0 0 0 0 0 0 0 0 0 0 0 0 0 0 0 0 0 0 0 0 0 0 0 0
0 0 0 0 12 14 15 13 13 13 13 13 13 13 16 17 12 18 13 14 15 13 13 13 13 13 16 17 12 14 15 13 13 13 13 13 13 13 16 17 0 0 0 0 0 0 0 0 0 0 0 0 0 0 0 0 0 0 0 0 0 0 0 0
0 0 0 0 12 18 13 13 13 13 13 13 13 13 16 17 12 18 13 13 13 13 13 13 13 13 16 17 12 18 13 13 13 13 13 13 13 13 16 17 0 0 0 0 0 0 0 0 0 0 0 0 0 0 0 0 0 0 0 0 0 0 0 0
0 0 0 0 12 19 19 13 13 19 13 13 13 13 16 17 12 18 21 21 13 13 19 19 13 13 16 17 12 19 19 13 13 13 19 19 20 13 16 17 0 0 0 0 0 0 0 0 0 0 0 0 0 0 0 0 0 0 0 0 0 0 0 0
0 0 0 0 12 18 13 13 13 13 13 13 20 20 19 17 12 18 13 13 13 13 13 13 13 13 16 17 12 13 13 13 13 13 13 13 13 13 16 17 0 0 0 0 0 0 0 0 0 0 0 0 0 0 0 0 0 0 0 0 0 0 0 0
0 0 0 0 12 18 13 20 21 13 21 13 13 13 16 17 12 18 13 13 13 13 13 13 21 20 16 17 12 13 19 20 13 13 21 13 13 13 16 17 0 0 0 0 0 0 0 0 0 0 0 0 0 0 0 0 0 0 0 0 0 0 0 0
0 0 0 0 12 18 13 22 13 13 13 13 13 20 19 17 12 18 19 19 21 13 13 13 13 22 16 17 12 13 13 13 13 13 13 13 19 20 19 17 0 0 0 0 0 0 0 0 0 0 0 0 0 0 0 0 0 0 0 0 0 0 0 0
0 0 0 0 12 18 13 13 13 13 13 19 13 13 16 17 12 18 13 13 13 13 13 13 13 13 16 17 12 18 13 13 13 13 13 13 13 13 16 17 0 0 0 0 0 0 0 0 0 0 0 0 0 0 0 0 0 0 0 0 0 0 0 0
0 0 0 0 12 19 13 19 19 20 13 13 13 13 16 17 12 18 13 20 13 20 19 13 13 20 16 17 12 19 19 13 19 20 13 13 13 13 16 17 0 0 0 0 0 0 0 0 0 0 0 0 0 0 0 0 0 0 0 0 0 0 0 0
0 0 0 0 23 24 25 25 25 25 25 25 25 25 26 27 23 24 25 25 25 25 25 25 25 25 26 27 23 24 25 25 25 25 25 25 25 25 26 27 0 0 0 0 0 0 0 0 0 0 0 0 0 0 0 0 0 0 0 0 0 0 0 0
0 0 0 0 2 27 28 29 30 30 30 30 30 30 30 30 31 32 28 29 30 30 30 30 30 30 30 30 31 32 28 29 30 30 30 30 30 30 30 30 31 0 0 0 0 0 0 0 0 0 0 0 0 0 0 0 0 0 0 0 0 0 0 0
0 0 0 0 0 0 0 0 0 0 0 0 0 0 0 0 0 0 0 0 0 0 0 0 0 0 0 0 0 0 0 0 0 0 0 0 0 0 0 0 0 0 0 0 0 0 0 0 0 0 0 0 0 0 0 0 0 0 0 0 0 0 0 0
