0 0 0 0 0 0 0 0 0 0 0 0 0 0 0 0 0 0 0 0 0 0 0 0 0 0 0 0 0 0 0 0 0 0 0 0 0 0 0 0 0 0 0 0 0 0 0 0 0 0 0 0 0
0 4 8 8 8 8 8 8 8 8 8 8 8 8 0 8 8 8 8 8 8 8 8 8 8 8 8 8 8 8 8 8 8 8 8 8 8 8 8 8 8 8 8 8 8 8 8 8 8 8 8 6 0
0 4 4 5 5 5 5 5 5 5 5 5 5 6 0 4 5 5 5 5 5 5 5 5 5 5 6 4 5 5 5 5 5 5 5 5 5 5 6 4 5 5 5 5 5 5 5 5 5 5 6 6 0
0 4 4 3 3 5 5 5 5 5 5 5 5 6 0 4 5 5 5 5 5 5 5 5 5 5 6 4 5 5 5 5 5 5 5 5 5 5 6 4 5 5 5 5 5 5 5 5 5 5 6 6 0
0 4 4 5 5 5 5 3 3 5 5 5 5 6 0 4 5 5 5 5 5 5 5 5 5 5 6 4 5 5 5 5 5 5 5 5 5 5 6 4 5 5 5 5 5 5 5 5 5 5 6 6 0
0 4 4 5 5 5 5 5 5 5 5 5 5 6 0 4 5 5 5 5 5 5 5 5 5 5 6 4 5 5 5 5 5 5 5 5 5 5 6 4 5 5 5 5 5 5 5 5 5 5 6 6 0
0 4 4 5 5 5 5 5 5 5 5 5 5 6 0 4 5 5 5 5 5 5 5 5 5 5 6 4 5 5 5 5 5 5 5 5 5 5 6 4 5 5 5 5 5 5 5 5 5 5 6 6 0
0 4 4 5 3 3 5 5 5 5 5 5 5 6 0 4 5 5 5 5 5 5 5 5 5 5 6 4 5 5 5 5 5 5 5 5 5 5 6 4 5 5 5 5 5 5 5 5 5 5 6 6 0
0 4 4 5 5 5 5 5 5 5 5 5 5 6 0 4 5 5 5 5 5 5 5 5 5 5 6 4 5 5 5 5 5 5 5 5 5 5 6 4 5 5 5 5 5 5 5 5 5 5 6 6 0
0 4 4 5 5 5 5 5 3 5 5 5 5 6 0 4 5 5 5 5 5 5 5 5 5 5 6 4 5 5 5 5 5 5 5 5 5 5 6 4 5 5 5 5 5 5 5 5 5 5 6 6 0
0 4 4 5 5 5 5 5 5 5 5 5 5 6 0 4 5 5 5 5 5 5 5 5 5 5 6 4 5 5 5 5 5 5 5 5 5 5 6 4 5 5 5 5 5 5 5 5 5 5 6 6 0
0 4 4 5 5 5 5 5 5 5 5 5 5 6 0 4 5 5 5 5 5 5 5 5 5 5 6 4 5 5 5 5 5 5 5 5 5 5 6 4 5 5 5 5 5 5 5 5 5 5 6 6 0
0 4 4 5 5 5 5 5 5 5 5 5 5 6 0 4 5 5 5 5 5 5 5 5 5 5 6 4 5 5 5 5 5 5 5 5 5 5 6 4 5 5 5 5 5 5 5 5 5 5 6 6 0
0 4 2 2 2 2 2 2 7 2 2 2 2 5 2 2 2 2 2 2 7 2 2 2 2 5 2 2 2 2 2 2 7 2 2 2 2 5 2 2 2 2 2 2 7 2 2 2 2 5 6 0 0
0 0 0 0 0 0 0 5 5 0 0 0 0 0 0 0 0 0 0 0 0 0 0 0 0 0 0 0 0 0 0 0 0 0 0 0 0 0 0 0 0 0 0 0 0 0 0 0 0 0 0 0 0
0 0 0 0 0 0 0 5 5 0 0 0 0 0 0 0 0 0 0 0 0 0 0 0 0 0 0 0 0 0 0 0 0 0 0 0 0 0 0 0 0 0 0 0 0 0 0 0 0 0 0 0 0
0 4 2 2 2 2 2 2 7 2 2 2 2 5 2 2 2 2 2 2 2 7 2 2 2 2 5 2 2 2 2 2 2 7 2 2 2 2 5 2 2 2 2 2 2 7 2 2 2 2 5 6 0
0 4 4 5 5 5 5 5 5 5 5 5 5 6 0 4 5 5 5 5 5 5 5 5 5 5 6 4 5 5 5 5 5 5 5 5 5 5 6 4 5 5 5 5 5 5 5 5 5 5 6 6 0
0 4 4 5 5 5 5 5 5 5 5 5 5 6 0 4 5 5 5 5 5 5 5 5 5 5 6 4 5 5 5 5 5 5 5 5 5 5 6 4 5 5 5 5 5 5 5 5 5 5 6 6 0
0 4 4 5 5 5 5 5 5 5 5 5 5 6 0 4 5 5 5 5 5 5 5 5 5 5 6 4 5 5 5 5 5 5 5 5 5 5 6 4 5 5 5 5 5 5 5 5 5 5 6 6 0
0 4 4 5 5 5 5 5 5 5 5 5 5 6 0 4 5 5 5 5 5 5 5 5 5 5 6 4 5 5 5 5 5 5 5 5 5 5 6 4 5 5 5 5 5 5 5 5 5 5 6 6 0
0 4 4 5 5 5 5 5 5 5 5 5 5 6 0 4 5 5 5 5 5 5 5 5 5 5 6 4 5 5 5 5 5 5 5 5 5 5 6 4 5 5 5 5 5 5 5 5 5 5 6 6 0
0 4 4 5 5 5 5 5 5 5 5 5 5 6 0 4 5 5 5 5 5 5 5 5 5 5 6 4 5 5 5 5 5 5 5 5 5 5 6 4 5 5 5 5 5 5 5 5 5 5 6 6 0
0 4 4 5 5 5 5 5 5 5 5 5 5 6 0 4 5 5 5 5 5 5 5 5 5 5 6 4 5 5 5 5 5 5 5 5 5 5 6 4 5 5 5 5 5 5 5 5 5 5 6 6 0
0 4 4 5 5 5 5 5 5 5 5 5 5 6 0 4 5 5 5 5 5 5 5 5 5 5 6 4 5 5 5 5 5 5 5 5 5 5 6 4 5 5 5 5 5 5 5 5 5 5 6 6 0
0 4 4 5 5 5 5 5 5 5 5 5 5 6 0 4 5 5 5 5 5 5 5 5 5 5 6 4 5 5 5 5 5 5 5 5 5 5 6 4 5 5 5 5 5 5 5 5 5 5 6 6 0
0 4 4 5 5 5 5 5 5 5 5 5 5 6 0 4 5 5 5 5 5 5 5 5 5 5 6 4 5 5 5 5 5 5 5 5 5 5 6 4 5 5 5 5 5 5 5 5 5 5 6 6 0
0 4 4 5 5 5 5 5 5 5 5 5 5 6 0 4 5 5 5 5 5 5 5 5 5 5 6 4 5 5 5 5 5 5 5 5 5 5 6 4 5 5 5 5 5 5 5 5 5 5 6 6 0
0 4 4 5 5 5 5 5 5 5 5 5 5 6 0 4 5 5 5 5 5 5 5 5 5 5 6 4 5 5 5 5 5 5 5 5 5 5 6 4 5 5 5 5 5 5 5 5 5 5 6 6 0
0 4 8 8 8 8 8 8 8 8 8 8 8 8 0 8 8 8 8 8 8 8 8 8 8 8 8 8 8 8 8 8 8 8 8 8 8 8 8 8 8 8 8 8 8 8 8 8 8 8 8 6 0
0 0 0 0 0 0 0 0 0 0 0 0 0 0 0 0 0 0 0 0 0 0 0 0 0 0 0 0 0 0 0 0 0 0 0 0 0 0 0 0 0 0 0 0 0 0 0 0 0 0 0 0 0